; Katakana => Romaji mapping table
; Copyright (c) 1996-2003 Aaron Chan, litedev Software

[Mapping]
ア=a
イ=i
ウ=u
エ=e
オ=o
カ=ka
キ=ki
ク=ku
ケ=ke
コ=ko
サ=sa
シ=shi
ス=su
セ=se
ソ=so
タ=ta
チ=chi
ツ=tsu
テ=te
ト=to
ナ=na
ニ=ni
ヌ=nu
ネ=ne
ノ=no
ハ=ha
ヒ=hi
フ=fu
ヘ=he
ホ=ho
マ=ma
ミ=mi
ム=mu
メ=me
モ=mo
ヤ=ya
ユ=yu
ヨ=yo
ラ=ra
リ=ri
ル=ru
レ=re
ロ=ro
ワ=wa
ヲ=wo
ン=n

ガ=ga
ギ=gi
グ=gu
ゲ=ge
ゴ=go
ザ=za
ジ=ji
ズ=zu
ゼ=ze
ゾ=zo
ダ=da
ヂ=ji
ヅ=zu
デ=de
ド=do
バ=ba
ビ=bi
ブ=bu
ベ=be
ボ=bo
パ=pa
ピ=pi
プ=pu
ペ=pe
ポ=po

キャ=kya
キュ=kyu
キョ=kyo
シャ=sha
シュ=shu
ショ=sho
チャ=cha
チュ=chu
チョ=cho
ニャ=nya
ニュ=nyu
ニョ=nyo
ヒャ=hya
ヒュ=hyu
ヒョ=hyo
ミャ=mya
ミュ=myu
ミョ=myo
リャ=rya
リュ=ryu
リョ=ryo
ギャ=gya
ギュ=gyu
ギョ=gyo
ジャ=ja
ジュ=ju
ジョ=jo
ヂャ=ja
ヂュ=ju
ヂョ=jo
ビャ=bya
ビュ=byu
ビョ=byo
ピャ=pya
ピュ=pyu
ピョ=pyo

ィェ=ye
ゥィ=wi
ゥェ=we
ゥォ=wo
クァ=kwa
クィ=kwi
クェ=kwe
クォ=kwo
グァ=gwa
グィ=gwi
グェ=gwe
グォ=gwo
シェ=she
ジェ=je
ティ=ti
テゥ=tu
テュ=tyu
ディ=di
デゥ=du
デュ=dyu
ツァ=tsa
ツィ=tsi
ツェ=tse
ツォ=tso
ファ=fa
フィ=fi
フュ=fyu
フェ=fe
フォ=fo
ヴァ=va
ヴィ=vi
ヴュ=vyu
ヴェ=ve
ヴォ=vo

ァ=a
ィ=i
ゥ=u
ェ=e
ォ=o
ヵ=ka
ヶ=ke
ッ=s-tsu
ャ=ya
ュ=yu
ョ=yo
ヮ=wa

ヰ=wi
ヱ=we
ヷ=va
ヸ=vi
ヴ=vu
ヹ=ve
ヺ=vo